WWWWWWWWWWWWW
W           W
B           GEG
B  # *      |!E
W           GEG
W           W
W         @ W
WWWWWWWWWWWWW
